XXXXXXXXXXXXXXXXXXXXXXXXXXXXXXXX
X-----XF-------------------X---X
X-P-P-XF------X-----X----------X
X-----X-----------X-X-------X--X
XX---XXXXXXXXXXXXXXXXXXXXXXX---X
X----XXXXXXXXXXXXXXXXXXXXXXX---X
X-X----X------X---------X------X
X----------X----------------X--X
XXXXXXXXXXXXXXXXXXXXXXXXXXXXXXXX
