XXXXXXXXXXXXXXXXXXXXXXXXXXXXXXXX
XP-P-XF--------------------X---X
X----XF------X-----X-----------X
X---XX------------X-X-------X--X
XX--XXXXXXXXXXXXXXXXXXXXXXXX---X
X----XXXXXXXXXXXXXXXXXXXXXXX---X
X-X----X------X---------X------X
X----------X----------------X--X
XXXXXXXXXXXXXXXXXXXXXXXXXXXXXXXX
