XXXXXXXXXXXX
XP--X--X--XX
XPX-----F--X
X---X---X--X
XP---------X
XXXXXXXXXXXX