XXXXXXXXXX
XX---XX--X
XP-------F
XP--XXX--F
XP-------F
XXXX----XX
XXXXXXXXXX